POSIX Thread Programming:
FILE			S		TITLE
------------------------------------------------------------------------------------------
routine001.c	OK		simple example program that uses POSIX threads
routine002.c	OK		Synchronized swimming
routine003.c	OK		simple.c -- multithreaded "hello world"
routine004.c	OK		Printing thread IDs
routine005.c	OK		Fetching the thread exit status
routine006.c	OK		Incorrect use of pthread_exit argument
routine007.c	OK		Thread cleanup handler
routine008.c	OK		Using a mutex to protect a data structure
routine009.c	O		Using two mutexes
routine010.c	O		Simplified locking
routine011.c	O		Using readerwriter locks
routine012.c	O		Using condition variables
routine013.c	O		Creating a thread in the detached state
routine014.c	O		Using a recursive mutex
routine015.c	O		A nonreentrant version of getenv
routine016.c	O		A reentrant (thread-safe) version of getenv
routine017.c	O		A thread-safe, compatible version of getenv
routine018.c	O		Synchronous signal handling
routine019.c	O		pthread_atfork example

